111111111111111111111111111111111111111111111111111111111111
1E00000000000000000000000000000000000000000000000000000000C1
100000000000000000000000000000000000000000000M00000000000001
100000000000000000000000000000000000000M00000000000000000001
100000000C00000000000000000000000000000000000000000000000001
100001111111111111111111111111111111111111111111111111110001
100001000000000000000000000000000000000000000000000000010001
100001000000111100000000111111000000000000000000000000010001
100001000001111100000001111111100000000000000000000000010001
1000010000110011000000010000011000000000M0000000000000010001
100001000110001100000000000011000000000000000000000000010001
100001001100001100000000000110000000000000000000000000010001
100001011000001100000000001100000100000000000000000000010001
100001011111111111100000011000000100100100010111101001010001
100001000000001100000000110000000100100010100100101101010001
100001000000001100000001100000000100100001000100101011010001
1000010000M0001100000011111111100100111101000111101001010001
100001000000000000000000000000000000000000000000000000010001
100001111111111111111111111111111111111111111111111111110001
1000000000000000000000000000000000000000C0000000000000000001
10000000000000M000000000000000000000000000000000000000000001
101001010100000000000000000M00000000000000000000000M00000001
111010101010000C000000000000000000000000M0000000000000000001
1000000000000000000000000000000000000M0000000000000000000001
101110100000000000000000000000000000000000000000000000000001
1C00001110001000000000001111100000000000000000000M0000000001
1C100000000010100000000000000000000000000000M000000000000001
1111111111111010111110000000000C0000000000000000000000000001
10000000000000010000000M0000000C0000000000000000000000000001
1011101111111011000000000000000C000000000000M000000000000001
10100000000000010100000000000000000000000M000000000000000001
101000000011111100110000000000000000000000000000000000000001
1P100000000000000001000000000000000M0000000000000000000C0001
111111111111111111111111111111111111111111111111111111111111
