1111111
10PE1C1
1011101
1000001
1111111
