111111111111111111111111
1P000CM00111100001100011
100000110011100001100001
100000000000000100000001
101110111111101100000001
100000000000000000000001
101000M00011111100111111
1010000000000000000C00E1
111111111111111111111111
