111111111111111111111111
1P000CM00111100001100011
100000110011100001100001
100000000000000100001001
101111101111101100M00001
110000000000000000000001
101000100011111110111111
1010000000000000000C0001
1C000CM00111100001100011
100001110011100001100001
110000000000000100000001
101110111111101100000001
1000000000000M0000000001
101000M01011111100111111
1010000C00000000000C00E1
111111111111111111111111
