11111111111111111
10000000000P111E1
10000000011111101
10000011111111001
10111111111110011
10000000000000111
11111111111111111
