1111111111
10000001E1
0PE0000011
1111111111
