11111111111
1EC10000111
10100011001
11111111111
